
  _____   ____ ___________ ____  __  __     _____ _____ ______ _______          _______ ________     __
 |  __ \ / __ \___  /_   _/ __ \|  \/  |   |  __ \_   _|  ____|  __ \ \        / / ____|___  /\ \   / /
 | |__) | |  | | / /  | || |  | | \  / |   | |__) || | | |__  | |__) \ \  /\  / / (___    / /  \ \_/ / 
 |  ___/| |  | |/ /   | || |  | | |\/| |   |  ___/ | | |  __| |  _  / \ \/  \/ / \___ \  / /    \   /  
 | |    | |__| / /__ _| || |__| | |  | |   | |    _| |_| |____| | \ \  \  /\  /  ____) |/ /__    | |   
 |_|     \____/_____|_____\____/|_|  |_|   |_|   |_____|______|_|  \_\  \/  \/  |_____//_____|   |_|   
                                                                                                       
                                                                                                       
