
  _____   ____ ___________ ____  __  __     _____  _____  _    _  _____ _____ 
 |  __ \ / __ \___  /_   _/ __ \|  \/  |   |  __ \|  __ \| |  | |/ ____|_   _|
 | |__) | |  | | / /  | || |  | | \  / |   | |  | | |__) | |  | | |  __  | |  
 |  ___/| |  | |/ /   | || |  | | |\/| |   | |  | |  _  /| |  | | | |_ | | |  
 | |    | |__| / /__ _| || |__| | |  | |   | |__| | | \ \| |__| | |__| |_| |_ 
 |_|     \____/_____|_____\____/|_|  |_|   |_____/|_|  \_\\____/ \_____|_____|
                                                                              
                                                                              
