
  _____   ____ ___________ ____  __  __     _______ _____   ____________ _____ _____ 
 |  __ \ / __ \___  /_   _/ __ \|  \/  |   |__   __|  __ \ |___  /  ____/ ____|_   _|
 | |__) | |  | | / /  | || |  | | \  / |      | |  | |__) |   / /| |__ | |      | |  
 |  ___/| |  | |/ /   | || |  | | |\/| |      | |  |  _  /   / / |  __|| |      | |  
 | |    | |__| / /__ _| || |__| | |  | |      | |  | | \ \  / /__| |___| |____ _| |_ 
 |_|     \____/_____|_____\____/|_|  |_|      |_|  |_|  \_\/_____|______\_____|_____|
                                                                                     
                                                                                     
